EA ./textures/danger_door.xpm
NO ./textures/blue_wall.xpm   
SO ./textures/red_wall.xpm
WE ./textures/grey_wall.xpm

F       2, 4, 47
C       25, 7,0


1111111111111111111111111
1111111111111111111111111
10000000000110000000000001
1111111111111111111111111                
1111111111111111111111111  
1011000001110000000000001
100100000000000000000000111111111
111111111111111111111111111111111111111111
111111111111111111111111111111111111111111
10111111101100000111000000000000111011
100000000011000001110111111111111110111111111111111111111111111111111111111
1111011111111101110000000000000000E00000000000000000000000000000000000001
11110111111111011101010010000000000000000000000000000000000000000000000001
11000000110101011100000010000000000000000000100000000000000000000000000001
10000000000000001100000010000000000000000000010000000000000000000000000001
10000000000000001101010010000000000000000000000000000000000000000000000001
11000011101010111110111100000000000000000000000000000000000000000000000001
11110011 1110101 101111010100001111110111111110111111110111111111110001111
11111011 1111111 111111111100001    101      101      101         1000011
    101                   100001    101      101      101         11100011
    101                   100001    101      101      101           110001
    101                   100001    101      101      101            10001
    101                   100001    101      101      101            10001
11111011111 111111        100001    101      101      101        1111100011
10000000001100000111111111100001111110111111110111111110111111111100000011111111111111111
10000000000100000000000000100000000000000000000000000000000000000000000000000000000001
10000010000100000001000000100000001000000111111111111111101111111111111111111111111011
100000100001000000010000001000000010000001              101               111111111011
100000100001000000010000001000000010000001              101               1111111110001
100000100000000000010000001000000010000001              101               1111111111101
100000100000000000010000000000000010000001              101               1111111111101
11111111111111111111111111111110001111111               101               1111111111001
100000000000000000000000000000000000000001              101               11111111111011
100000000000000000000000000000000000000001              101               111111111110001
100000000000000000000000000000000000000001              101                11111111111011
1000000000000000000000000000000000000000011111111111111110111111111111111111111111111101
1000000000000000000000000000000000000000000000000000000000000000000000000000000000000001                              1111
1000000000000000000000000000000000000000011111111111111111111111111111111111111111111111
100000000000000000000000000000000000000001                              1111111111111
1000000000000000000000000000000000000000001
1111111111111111111111111111111111111111111
